<body background="A3.jpg">

<p><center><h1>Fox Fitness Taco Spin Bike (Yarış ) Kondisyon Bisikleti</h1></center></p>

<center><img src="kondisyon1.jpg"/img></center>

<p><center><h1>ÜRÜN ÖZELLİKLERİ</h1></center></p>
<p><center><font size=5 Ağırlık	29 Kg<br>
Ayarlanabilir Sele	Var<br>
Bisiklet Tipi	Spin Bike<br>
Çalışma Tipi	Manyetik<br>
Direnç Mekanizması	Manuel ayarlanabilir<br>
Disk Ağırlığı	10 kg<br>
Ebatlar	106 x 61 x 16 cm<br>
Gösterge	LCD Gösterge<br>
Nabız Ölçme Sistemi	Yok<br>
Program Sayısı	Yok<br>
Renk	Siyah<br>
Seçenek	Yok<br>
Taşıma Kapatsitesi	100 kg<br>
Diğer<br>
Garanti Süresi (Ay)	24<br>
Yurt Dışı Satış	Yok<br>
Stok Kodu	HBV00000OLBOX
</font></center></p>