<body background="A3.jpg">

<p><center><h1>Dynamic Fluence Plus Motorlu Masajlı Koşu Bandı</h1></center></p>

<center><img src="kosu1.jpg"/img></center>

<p><center><h1>ÜRÜN ÖZELLİKLERİ</h1></center></p>
<p><center><font size=5  
Adımsayar	Yok<br>
Ağırlık	56kg<br>
Bant Boyu	123 cm<br>
Bant Ebatları	43cmx123cm<br>
Bant Genişliği	43 cm<br>
Çalışma Tipi	Masajlı - Motorlu<br>
Dokunmatik Ekran	Yok<br>
Ebatlar	162x70x120<br>
Eğim Derecesi	5 Kademe Manuel Ayarlanabilir<br>
Eğim	Var<br>
Gürültü	50-55db<br>
Katlanabilme	Var<br>
Masaj	Var<br>
Max.Hız	0 - 15 km/s<br>
Motor Gücü	2,5 hp<br>
Mp3 Çalar	Var<br>
Nabız Ölçme Sistemi	Elden Nabız Ölçer<br>
Program	Var<br>
Taşıma Kapasitesi	110 kg<br>
Zemin Türü	6pcs Six Cushion Deck<br>
Diğer<br>
Garanti Süresi (Ay)	24<br>
Yurt Dışı Satış	Yok<br>
Stok Kodu	HBV00000PKLGI
</font></center></p>